11111111111111111111111111111111111
11111111111111111111111111111111111
10000101000000000000000000000000001
10000000000000000000000000000000001
10000000P00000000000000CCC000000001
10000000000000000000000000000000001
100000000000000000E0000000000000001
10111111111111111111110000000000001
10111111000000000000000111111111111
11111111111111111111111111111111111
